11111111111111111111111111111111111100000000000000000000000000000000000000000000000000000000000000000000000000000000000111111111111111111111111111111111111
11111111111111111111111111111111111111100000000000000000000000000000000000000000000000000000000000000000000000000000111111111111111111111111111111111111111
11111111111111111111111111111111111111111111100000000000000000000000000000000000000000000000000000000000000000111111111111111111111111111111111111111111111
11111111911111111111111111111111111111101111111111110000000000000000000000000000000000000000000000000001111111111111111111111111111111111111110111111111111
11111111111111111111111111111111110111111111100111111111100000000000000000000000000000000000000000111111111111111111111111111111111111111111111111111101111
11111111111111111111111111111111111111111111111111110111111000000000000000000000000000000000000000001111111111111111111111111111111111111111111111111111011
11111111111111111119111111111111111011111911111111111111111000000000000000000000000000000000000000000011111111111111111111111111111111111011111111111111111
11111911111111111111111111111111111111111100111111111111100000000000000000000000000000000000000000000000000000111111111111111111111111111111111111111111111
11111111111111111111111111111111111111110000111110001191111111111000000000000000000000000000000000000000000000000000000000001111111111111111111111111111111
11111111111111111111111111111000111911111100011111111111111111100000000000000000000000000000000000000000000000000000000000000000001111111111100000001111111
11111111111111111111111111111111011111111111001111110001111000000000000000000000000000000000000000000000000000000000000000000000000001111111000000000011111
11111111111111111111111111111111111101111111111111111001111000000000000000000000000000000000000000000000000000000000000000000000000000000111000000000001111
11111111111111111111111111011111110000111111111111111111111100000000000000000000000000000000000000000000000000000000000000000000000000000011000000000011111
11111111111111111191111111111111111110111191111111111111111000000000000000000000000000000000000000000000000000000000000000000000000000000001000000000111111
11111111111111111111111111111111111111111111111111111111111000000000000000000000000000000000000000000000000000000000000000000000000000000000000000011111111
11111111111111111111111111111111111111111111111111111111111110000000000000000000000000000000000000000000000000000000000000000000110000000000000000111111111
11111111111111111111111111111111111111111111111111111111111100000000000000000000000000000000000000000000000000000000000000000000111000000000000011111111111
11111111111111111111111111111111111111111111111111191111111000000000000000000000000000000000000000000000000000000000000000000000111100000000001111111111111
11111111111111111119111111111111111111111111111111111111111000000000000000000000000000000000000000000000000000000000000000000000111111111111111111111111111
11111119111111111111111111111111111111111111111111111111111000000000000000000000000000000000000000000000000000000000000000000011111111111111111111111111111
11111111111111111111111111111111110111111111100111111111100000000000000000000000000000000000000000000000000000000000000000011111111111111111111111111111111
11111111111111111111111111111111111111101111111111110000000000000000000000000000000000000000000000000000000000000000000000011111111111111111111111111111111
11111111111111111111111111111111111111111111100000000000000000000000000000000000000000000000000000000000000000000000000000000111111111111111111111111111111
11111111111111111111111111111111111111100000000000000000000000000000000000000000000000000000000000000000000000000000000000000001111111111111111111111111111
11111111111111111111111111111111111100000000000000000000000000000000000000000000000000000000000000000000000000000000000000000000111111111111111111111111111
11111111111111111111111111111111119100001110000000000000000000000000000000000000000000000000000000000000000000000000000000000000000111111111111111111111111
11111111111111111111111111111111111100000019100000000000000000000000000000000000000000000000000000000000000000000000000000000000000000000111111111111111111
11111111119111111111111111111111111000000011000000000000000000000000000000000000000000000000000000000000000000000000000000000000000000000000000111111111111
11111111111111111111111111111111111100000001000000000000000000000000000000000000000000000000000000000000000000000000000000000000000000000000000000000111000
11111111111111111111111111111111111110000000000000000000000000000000000000000000000000000000000000000000000000000000000000000000000000000000000000000000000
11111111111111111111111111111111111100000000000000000000000000000000000000000000000000000000000000000000000000000000000111111111111111111111111111111111111
11111111111111111111111111911111111111100000000000000000000000000000000000000000000000000000000000000000000000000000111111111111111111111111111111111111111
11111111111111111111111111111111111111111111100000000000000000000000000000000000000000000000000000000000000000111111111111111111111111111111111111111111111
11111111111111111111111111111111111111101111111111110000000000000000000000000000000000000000000000000001111111111111111111111111111111111111110111111111111
11111119111111111111111111111111110111111111100111111111100000000000000000000000000000000000000000111111111111111111111111111111111111111111111111111101111
11111111111111111111111111111111111111111111111911110111111000000000000000000000000000000000000000001111111111111111111111111111111111111111111111111111011
11111111111111111111111111111111111011111111111111111111111000000000000000000000000000000000000000000011111111111111111111111111111111111011111111111111111
11111111111111111111111111111111111111111100111111111111100000000000000000000000000000000000000000000000000000111111111111111111111111111111111111111111111
11111111111111111111111111111111119111110000111110001111111111111000000000000000000000000000000000000000000000000000000000001111111111111111111111111111111
11111111111111111111111111111000111111111100011111111111911111100000000000000000000000000000000000000000000000000000000000000000001111111111100000001111111
11111111111111111111111111111111011111111111001111110001111000000000000000000000000000000000000000000000000000000000000000000000000001111111000000000011111
11111111111111111111111111111111111101111191111111111001111000000000000000000000000000000000000000000000000000000000000000000000000000000111000000000001111
11111111111111111111111111011111110000111111111111111111111100000000000000000000000000000000000000000000000000000000000000000000000000000011000000000011111
11111111111111111111111111111111111110111111111111111111111000000000000000000000000000000000000000000000000000000000000000000000000000000001000000000111111
11111111119111111111111111111111111111111111111111111111111000000000000000000000000000000000000000000000000000000000000000000000000000000000000000011111111
11111111111111111111111111111111111111111111111111111111111110000000000000000000000000000000000000000000000000000000000000000000110000000000000000111111111
11111111111111111111111111111111111111119111111111111111111100000000000000000000000000000000000000000000000000000000000000000000111000000000000011111111111
11111111111111111111111111111111111111111111111111111111111000000000000000000000000000000000000000000000000000000000000000000000111100000000001111111111111
11111111111111111111111111111111111111111111111111111111111000000000000000000000000000000000000000000000000000000000000000000000111111111111111111111111111
11111111111111111111111111111111111111111111111111111111111000000000000000000000000000000000000000000000000000000000000000000011111111111111111111111111111
11111111111111911111111111111111110111111111100111111111100000000000000000000000000000000000000000000000000000000000000000011111111111111111111111111111111
11111111111111111111111111111111111111101111111111110000000000000000000000000000000000000000000000000000000000000000000000011111111111111111111111111111111
11111111111111111111111111111111111111111111100000000000000000000000000000000000000000000000000000000000000000000000000000000111111111111111111111111111111
11111111111111111111111111111111111111100000000000000000000000000000000000000000000000000000000000000000000000000000000000000001111111111111111111111111111
11111111111111111111111111111111111100000000000000000000000000000000000000000000000000000000000000000000000000000000000000000000111111111111111111111111111
11111111111111111111111111111111111100001110000000000000000000000000000000000000000000000000000000000000000000000000000000000000000111111111111111111111111
11111111111111111111111111111111111100000011000000000000000000000000000000000000000000000000000000000000000000000000000000000000000000000111111111111111111
11111111191111111111111111111111111000000011000000000000000000000000000000000000000000000000000000000000000000000000000000000000000000000000000111111111111
11111111111111111111111111111111111100000001000000000000000000000000000000000000000000000000000000000000000000000000000000000000000000000000000000000111000
11111111111111111111111111111111111110000000000000000000000000000000000000000000000000000000000000000000000000000000000000000000000000000000000000000000000
11111111111111111111111119111111111100000000000000000000000000000000000000000000000000000000000000000000000000000000000111111111111111111111111111111111111
11111111111111111111111111111111111111100000000000000000000000000000000000000000000000000000000000000000000000000000111111111111111111111111111111111111111
11111111111111111111111111111111111111111111100000000000000000000000000000000000000000000000000000000000000000111111111111111111111111111111111111111111111
11111111111119111111111111111111111111101111119111110000000000000000000000000000000000000000000000000001111111111111111111111111111111111111110111111111111
11111111111111111111111111111111110111111111100111111111100000000000000000000000000000000000000000111111111111111111111111111111111111111111111111111101111
11111111111111111111111111111111111111111111111111110111111000000000000000000000000000000000000000001111111111111111111111111111111111111111111111111111011
11111111111111111111111111111111111011111111111111111111111000000000000000000000000000000000000000000011111111111111111111111111111111111011111111111111111
11111111111111111111111111111111111111111100111111111111100000000000000000000000000000000000000000000000000000111111111111111111111111111111111111111111111
11111111111111111111111911111111111111110000111110001111111111111000000000000000000000000000000000000000000000000000000000001111111111111111111111111111111
11111111111111111111111111111000111111111100011111111111191111100000000000000000000000000000000000000000000000000000000000000000001111111111100000001111111
11111111111111111111111111111111011111111111001111110001111000000000000000000000000000000000000000000000000000000000000000000000000001111111000000000011111
11111111111119111111111111111111111101119111111111111001111000000000000000000000000000000000000000000000000000000000000000000000000000000111000000000001111
11111111111111111111111111011111110000111111111111111111111100000000000000000000000000000000000000000000000000000000000000000000000000000011000000000011111
11111111111111111111111111111111111110111111111111111111111000000000000000000000000000000000000000000000000000000000000000000000000000000001000000000111111
11111111111111111111111111111111111111111111111111111111111000000000000000000000000000000000000000000000000000000000000000000000000000000000000000011111111
11111111111111111111111111111111111111111111111111111119111110000000000000000000000000000000000000000000000000000000000000000000110000000000000000111111111
11111111111111111111111111111111111111111111111111111111111100000000000000000000000000000000000000000000000000000000000000000000111000000000000011111111111
11111111111111111111111111111111111111111111111111111111111000000000000000000000000000000000000000000000000000000000000000000000111100000000001111111111111
11111111111111111111111111111111111111111111111111111111111000000000000000000000000000000000000000000000000000000000000000000000111111111111111111111111111
11111111111111111111111111111111111111111111111111111111111000000000000000000000000000000000000000000000000000000000000000000011111111111111111111111111111
11111111111111119111111111111111110111111111100111111111100000000000000000000000000000000000000000000000000000000000000000011111111111111111111111111111111
11111111111111111111111111111111111111101111111111110000000000000000000000000000000000000000000000000000000000000000000000011111111111111111111111111111111
11111111111111111111111111111111111111111111100000000000000000000000000000000000000000000000000000000000000000000000000000000111111111111111111111111111111
11111111111111111111111111111111111111100000000000000000000000000000000000000000000000000000000000000000000000000000000000000001111111111111111111111111111
11111111111111111111111111111111111100000000000000000000000000000000000000000000000000000000000000000000000000000000000000000000111111111111111111111111111
11111111111111111111111111111111111100001110000000000000000000000000000000000000000000000000000000000000000000000000000000000000000111111111111111111111111
11111111111111111111111119111111111100000011000000000000000000000000000000000000000000000000000000000000000000000000000000000000000000000111111111111111111
11111111111111111111111111111111111000000011000000000000000000000000000000000000000000000000000000000000000000000000000000000000000000000000000111111111111
11111111119111111111111111111111111100000001000000000000000000000000000000000000000000000000000000000000000000000000000000000000000000000000000000000111000
11111111111111111111111111111111111110000000000000000000000000000000000000000000000000000000000000000000000000000000000000000000000000000000000000000000000
11111111111111111111111111111111111100000000000000000000000000000000000000000000000000000000000000000000000000000000000111111111111111111111111111111111111
11111111111111111111111111111111111111100000000000000000000000000000000000000000000000000000000000000000000000000000111111111111111111111111111111111111111
11111111111111111111111111111111111111111111100000000000000000000000000000000000000000000000000000000000000000111111111111111111111111111111111111111111111
11111111111111111111111111111111111111101111111111110000000000000000000000000000000000000000000000000001111111111111111111111111111111111111110111111111111
11111111111111111111111111111111110111111111100111111111100000000000000000000000000000000000000000111111111111111111111111111111111111111111111111111101111
11111111111111111111111111111111111111111111111111110111111000000000000000000000000000000000000000001111111111111111111111111111111111111111111111111111011
11111111111111111111111111111111111011111111111111111111111000000000000000000000000000000000000000000011111111111111111111111111111111111011111111111111111
11111111111111111111111111111111111111111100111111111111100000000000000000000000000000000000000000000000000000111111111111111111111111111111111111111111111
11111111111111111111111111111111111111110000111110001111111111111000000000000000000000000000000000000000000000000000000000001111111111111111111111111111111
11111111111111111111111111111000111111111100011111111111111111100000000000000000000000000000000000000000000000000000000000000000001111111111100000001111111
11111111111111111111111111111111011111111111001111110001111000000000000000000000000000000000000000000000000000000000000000000000000001111111000000000011111
11111111111111111111111111111111111101111111111111111001111000000000000000000000000000000000000000000000000000000000000000000000000000000111000000000001111
11111111111111111111111111011111110000111111111111111111111100000000000000000000000000000000000000000000000000000000000000000000000000000011000000000011111
11111111111111111111111111111111111110111111111111111111111000000000000000000000000000000000000000000000000000000000000000000000000000000001000000000111111
11111111111111111111111111111111111111111111111111111111111000000000000000000000000000000000000000000000000000000000000000000000000000000000000000011111111
11111111111111111111111111111111111111111111111111111111111110000000000000000000000000000000000000000000000000000000000000000000110000000000000000111111111
11111111111111111111111111111111111111111111111111111111111100000000000000000000000000000000000000000000000000000000000000000000111000000000000011111111111
11111111111111111111111111111111111111111111111111111111111000000000000000000000000000000000000000000000000000000000000000000000111100000000001111111111111
11111111111111111111111111111111111111111111111111111111111000000000000000000000000000000000000000000000000000000000000000000000111111111111111111111111111
11111111111111111111111111111111111111111111111111111111111000000000000000000000000000000000000000000000000000000000000000000011111111111111111111111111111
11111111111111111111111111111111110111111111100111111111100000000000000000000000000000000000000000000000000000000000000000011111111111111111111111111111111
11111111111111111111111111111111111111101111111111110000000000000000000000000000000000000000000000000000000000000000000000011111111111111111111111111111111
11111111111111111111111111111111111111111111100000000000000000000000000000000000000000000000000000000000000000000000000000000111111111111111111111111111111
11111111111111111111111111111111111111100000000000000000000000000000000000000000000000000000000000000000000000000000000000000001111111111111111111111111111
11111111111111111111111111111111111100000000000000000000000000000000000000000000000000000000000000000000000000000000000000000000111111111111111111111111111
11111111111111111111111111111111111100001110000000000000000000000000000000000000000000000000000000000000000000000000000000000000000111111111111111111111111
11111111111111111111111111111111111100000011000000000000000000000000000000000000000000000000000000000000000000000000000000000000000000000111111111111111111
11111111111111111111111111111111111000000011000000000000000000000000000000000000000000000000000000000000000000000000000000000000000000000000000111111111111
11111111111111111111111111111111111100000001000000000000000000000000000000000000000000000000000000000000000000000000000000000000000000000000000000000111000
11111111111111111111111111111111111110000000000000000000000000000000000000000000000000000000000000000000000000000000000000000000000000000000000000000000000